// 3d column ‘S’ for searching a prefix, ‘N’ otherwise
// 4th column ‘D’ rule is only activated to reflect Devanagari code modification, ‘N’ otherwise

ṃ	ṁ	N	N
kuḍaṁ	kuṇḍ	N	D
aṁā	āṁ	S	N
ūṁā	ūṁ	N	D
ḍēṁā	ḍōṅ	N	D
ṁk	ṅk	N	N
ṁg	ṅg	N	N
ṁṅ	ṅṅ	N	N
ṁc	ñc	N	N
ṁj	ñj	N	N
ṁñ	ññ	N	N
ṁṭ	ṇṭ	N	N
ṁḍ	ṇḍ	N	N
ṁṇ	ṇṇ	N	N
ṁt	nt	N	N
ṁd	nd	N	N
ṁl	nl	N	N
ṁḷ	nḷ	N	N
ṁn	nn	N	N
ṁp	mp	N	N
ṁb	mb	N	N
ṁm	mm	N	N
ṁr	ṇr	N	N
ṁs	ns	N	N
ṁś	ñś	N	N
ṁṣ	ṇṣ	N	N
ṁv	mv	N	N
ṁy	ñy	N	N
iba	bi	S	D
ibha	bhi	S	D
ica	ci	S	D
ida	di	S	D
iḍa	ḍi	S	D
idha	dhi	S	D
iḍha	ḍhi	S	D
iga	gi	S	D
igha	ghi	S	D
iha	hi	S	D
iin	in	S	D
ija	ji	S	D
ijha	jhi	S	D
ika	ki	S	D
ikha	khi	S	D
ila	li	S	D
ima	mi	S	D
ina	ni	S	D
ipa	pi	S	D
ipha	phi	S	D
ira	ri	S	D
isa	si	S	D
iśa	śi	S	D
ita	ti	S	D
iṭa	ṭi	S	D
itha	thi	S	D
iṭha	ṭhi	S	D
iva	vi	S	D
iya	yi	S	D
aai	ai	S	N
aau	au	S	N
maṁida	mandi	N	N
â	ā	N	N
î	ī	N	N
ô	ō	N	N
û	ū	N	N
aा	ā	N	N
aु	au	N	N
aो	ō	N	N
aे	ē	N	N
 िda	 di	N	N
 िna	 ni	N	N